11,11,100,100,0,10,



00,01,00,00,00,00,00,00,00,01,00

01,00,00,00,00,00,00,00,00,00,01

00,00,01,00,01,01,01,00,01,00,00

00,00,00,00,00,00,00,00,00,00,00

01,00,01,01,01,00,01,01,01,00,01

00,01,00,00,01,04,01,01,00,01,00

00,00,00,00,00,00,00,00,00,00,00

00,00,00,00,00,01,00,00,00,00,00

00,01,01,00,00,01,00,00,01,01,00

00,00,00,00,01,01,01,00,00,00,00

00,00,00,00,01,02,01,00,00,00,00
